_,_,_,_,_,_,_,_,_,_
_, , ,H,H,_,H,H,H,_
_, , , , , , , , ,_
_, , , , , , , , ,_
_, , , , , , , , ,_
_, , , , , , , ,_,_
_, ,_,n,U,_, , ,_,_
_, ,_,_,_,_, , ,_,_
_, ,_, , , , , , ,_
_, ,_, , , , ,O,<,_
_, ,H,H,H,H,H,H,_,_
_,_,_,_,_,_,_,_,_,_