_,_,_,_,_,_,_,_,_,_
_,H,H,H,H,H,H,H,H,_
_, , ,_, , , , , ,_
_, , ,_, , , , , ,_
_, , ,_, , , , , ,_
_, , ,_, , , , , ,_
_,O,<,_,n,U,_, , ,_
_, , ,_, , , , , ,_
_, , ,_, , , , , ,_
_, , ,_, , , , , ,_
_,H,H,H,H,H,H,H,H,_
_,_,_,_,_,_,_,_,_,_