_,_,_,_,_,_,_,_,_,_
_,O,<,_,_,_,_,_,_,_
_, , ,_,_,_,_,_,_,_
_, , ,_,_,_,_,_,_,_
_, , ,_,_,_,_,_,_,_
_, , ,_,_,_,_,_,_,_
_, , ,_,_,_,_,_,_,_
_, , ,_,_,_,_,_,_,_
_, , ,_,_,_,_,_,_,_
_, , ,_,_,_,_,_,_,_
_,n,U,_,_,_,_,_,_,_
_,_,_,_,_,_,_,_,_,_