_,_,_,_,_,_,_,_,_,_
_, , , , , , , , ,_
_, , , , , , , , ,_
_, , , , , , , , ,_
_, , , , , , , , ,_
_, , , , , , , , ,_
_, , , , , , , , ,_
_, , , , , , , , ,_
_,O,<,H,H,H,H,H,H,_
_, , , , , ,_, ,_,_
_, , , , , ,_,n,U,_
_,_,_,_,_,_,_,_,_,_