_,_,_,_,_,_,_,_,_,_
_,O,<,_,H,H,H,H,H,_
_, , ,_, , ,_, , ,_
_, , ,_, , ,_, , ,_
_, , ,_, , ,_, , ,_
_, , ,_, , ,_, , ,_
_, , ,_, , ,_, , ,_
_, , ,_, , ,_, , ,_
_, , ,_, , ,_, , ,_
_, , ,_, , ,_, , ,_
_, ,H,H,H,H,_, , ,_
_,_,_,_,_,_,_,n,U,_